#############################################
#                     #         #           #
#                     #         #           #
#  ####               ###  ###  #           #
#          ####                 #     #     #
#          #          ###             #     #
#     #    #          #                     #
#     #    ####   #####                     #
#     #                   ######      #     #
#     #           ###          #      #     #
#######    #####  #            #      #######
#                 #  ####      ####   #     #
#          #####  #                   #     #
#                                           #
#  ###  #  #####  ####  #  ####  ####       #
#    #  #               #     #     #   #   #
#    #  #    #          #     #     #   #   #
#  ###       #    #   ###     ###   #   #   #
#         ####    #                         #
#                 #                         #
#############################################
